普通牌 (Common)
中文名	英文名 (ID)	类型	稀有度
责罚  Castigation	攻击	普通
肃清	Purge	攻击	普通
落下法槌	GavelStrike	攻击	普通
判决	Verdict	攻击	普通
法典猛砸	CodeSmash	攻击	普通
恶意竞争	MaliciousCompetition	攻击	普通
我反对！	Objection	攻击	普通
你荆然敢！	BarbedRebuke	攻击	普通
强制传唤	ForcedSummons	攻击	普通
驳回	Overrule	攻击	普通
以伤换伤	BloodForBlood	攻击	普通
家族仲裁	FamilyArbitration	攻击	普通
镇暴	Quell	攻击	普通
肃清现场	ClearTheScene	攻击	普通
以牙还牙	ToothForTooth	攻击	普通
宣读罪状	ReadCharges	技能	普通
刺痛	Sting	技能	普通
坚固防守	SolidDefense	技能	普通
烂歌剧	BadOpera	技能	普通
小酌一杯	ASip	技能	普通
负荆前行	BurdenedJourney	技能	普通
淬炼	Tempering	技能	普通
紧急修补	EmergencyRepair	技能	普通
司法斟酌	JudicialDiscretion	技能	普通
罕见牌 (Uncommon)
中文名	英文名 (ID)	类型	稀有度
即刻行刑	ImmediateExecution	攻击	罕见
链锤猛击	FlailSmash	攻击	罕见
执法	LawEnforcement	攻击	罕见
破壁重击	WallBreakerSmash	攻击	罕见
连带责任	JointLiability	攻击	罕见
清算时刻	HourOfReckoning	攻击	罕见
裁决反冲	JudgementBacklash	攻击	罕见
刑责回溯	PenaltyRegression	攻击	罕见
法槌连击	GavelBarrage	攻击	罕见
法则修正	LawModification	技能	罕见
倾斜天平	TippingScales	技能	罕见
查阅卷宗	ConsultTheDossier	技能	罕见
挣脱枷锁	BreakTheShackles	技能	罕见
刚正不阿	Upright	技能	罕见
最后防线	LastStand	技能	罕见
庭审预演	CourtRehearsal	技能	罕见
休庭	Adjourn	技能	罕见
律法之重	WeightOfLaw	技能	罕见
法条援引	CitationOfLaw	技能	罕见
法网恢恢	InescapableNet	技能	罕见
自证其罪	SelfIncrimination	技能	罕见
你先动手的	JustifiedRetaliation	技能	罕见
案情梳理	CaseReconstruction	技能	罕见
待命裁定	PendingJudgment	技能	罕见
不成文的法律	UnwrittenLaw	技能	罕见
披荆斩棘	ThornyPath	能力	罕见
沉默之怒	SilenceWrath	能力	罕见
法律之名	InTheNameOfTheLaw	能力	罕见
荆棘冠冕	CrownOfThorns	能力	罕见
判例累积	CumulativePrecedent	能力	罕见
程序正义	ProceduralJustice	能力	罕见
铁律护体	IroncladDoctrine	能力	罕见
越界必罚	PunishmentForTransgression	能力	罕见
苦难辉光	GlowOfSuffering	能力	罕见
稀有牌 (Rare)
中文名	英文名 (ID)	类型	稀有度
审判	TheTrial	攻击	稀有
终审判决	FinalVerdict	攻击	稀有
有罪！	GuiltyAsCharged	攻击	稀有
无需宣判	NoSentenceNeeded	攻击	稀有
叙拉古的狼群	SyracusanWolves	技能	稀有
裁决早已开始	JudgmentHasBegun	技能	稀有
执行前准备	PreExecutionPrep	技能	稀有
复仇法典	CodeOfRevenge	能力	稀有
律法卫士	GuardianOfTheLaw	能力	稀有
法为正典	LawIsCanon	能力	稀有
坚定不移	Unwavering	能力	稀有
苦行	Asceticism	能力	稀有
调查现场	SceneInvestigation	能力	稀有